##########
#!#   # 5#
# # # # ##
#   #   ##
#1### ####
#       2#
### #### #
#@#  4#  #
#   #   ##
##########