######
#   2#
# #!##
#  #@#
#    #
######