##############
# 3 #   4# 8 #
# #  # #   # #
#  #   ##### #
## #7##@     #
#  #  #### # #
# #9#      # #
# # ###### # #
#       9  # #
# ########## #
#!          5#
##############